{
  "0": {
    "land": [
      [2, 2, 2, 2, 3, 2, 2, 2, 2, 2, 2, 2, 2, 2, 3, 2, 1, 2, 2, 2, 2, 1],
      [2, 2, 2, 2, 2, 2, 2, 2, 2, 2, 2, 2, 3, 2, 2, 2, 2, 2, 2, 2, 3, 2],
      [2, 1, 1, 1, 2, 2, 2, 1, 1, 1, 2, 2, 2, 2, 2, 2, 2, 2, 2, 2, 1, 1],
      [1, 2, 1, 1, 1, 2, 3, 1, 1, 2, 1, 1, 1, 1, 1, 2, 2, 3, 1, 1, 1, 1],
      [1, 1, 1, 2, 2, 1, 1, 2, 2, 1, 3, 1, 1, 1, 1, 1, 1, 2, 1, 1, 3, 1],
      [1, 1, 1, 2, 1, 1, 2, 2, 2, 2, 1, 1, 1, 1, 1, 1, 1, 1, 1, 1, 3, 1],
      [2, 3, 2, 2, 2, 2, 2, 2, 2, 1, 2, 1, 1, 1, 3, 2, 3, 1, 3, 2, 2, 2],
      [1, 2, 2, 2, 2, 2, 3, 3, 3, 1, 3, 1, 1, 2, 2, 2, 2, 2, 2, 2, 2, 2],
      [3, 2, 2, 2, 2, 2, 2, 2, 3, 3, 3, 2, 2, 3, 3, 2, 2, 2, 2, 2, 2, 2],
      [2, 2, 1, 1, 2, 2, 2, 2, 2, 2, 2, 2, 3, 3, 2, 2, 3, 2, 2, 1, 2, 2],
      [2, 1, 2, 2, 2, 2, 1, 1, 2, 2, 2, 1, 1, 1, 1, 1, 3, 2, 2, 1, 2, 2],
      [2, 2, 2, 2, 2, 2, 3, 1, 1, 2, 2, 1, 1, 1, 1, 1, 1, 2, 1, 1, 1, 2],
      [2, 2, 1, 2, 2, 2, 1, 1, 1, 3, 2, 2, 2, 1, 2, 2, 2, 1, 1, 1, 1, 2]
    ],
    "landform": [
      [0, 0, 0, 0, 0, 0, 0, 0, 0, 0, 0, 0, 0, 10, 0, 0, 0, 0, 0, 0, 10, 0],
      [0, 10, 4, 10, 10, 0, 0, 0, 0, 0, 0, 0, 0, 0, 0, 0, 0, 0, 0, 10, 0, 0],
      [10, 14, 0, 0, 0, 10, 10, 0, 0, 0, 0, 4, 4, 0, 0, 0, 11, 10, 10, 0, 4, 4],
      [10, 0, 0, 0, 0, 0, 0, 4, 0, 0, 10, 4, 4, 10, 0, 0, 4, 0, 0, 0, 0, 0],
      [0, 4, 4, 0, 0, 0, 0, 0, 10, 10, 0, 0, 0, 4, 10, 0, 4, 0, 0, 4, 0, 0],
      [0, 0, 10, 10, 0, 8, 0, 10, 10, 10, 0, 0, 14, 0, 4, 4, 4, 0, 0, 0, 0, 0],
      [0, 0, 0, 4, 4, 0, 10, 10, 0, 8, 0, 0, 0, 0, 0, 0, 0, 0, 0, 0, 0, 0],
      [0, 10, 0, 0, 4, 4, 0, 0, 0, 0, 0, 10, 0, 0, 10, 0, 10, 10, 10, 4, 4, 0],
      [0, 0, 0, 0, 7, 4, 0, 10, 4, 4, 0, 10, 0, 4, 0, 0, 5, 10, 0, 4, 0, 5],
      [0, 0, 0, 0, 0, 0, 0, 0, 0, 4, 4, 0, 0, 0, 0, 4, 0, 13, 0, 0, 0, 0],
      [4, 0, 0, 0, 0, 0, 0, 10, 10, 0, 0, 0, 0, 0, 0, 4, 4, 0, 0, 0, 0, 0],
      [0, 10, 10, 0, 0, 0, 0, 14, 4, 0, 0, 6, 0, 0, 0, 0, 4, 4, 0, 0, 0, 0],
      [0, 0, 0, 4, 4, 4, 0, 0, 0, 0, 10, 10, 0, 0, 0, 0, 0, 4, 4, 0, 12, 0]
    ]
  }
}
