{
  "0": {
    "land": [
      [2, 2, 2, 2, 3, 2, 2, 2, 2, 2, 2, 2, 2, 2, 3, 2, 1, 2, 2, 2, 2, 1],
      [2, 2, 2, 2, 2, 2, 2, 2, 2, 2, 2, 2, 3, 2, 2, 2, 2, 2, 2, 2, 3, 2],
      [2, 1, 1, 1, 2, 2, 2, 1, 1, 1, 2, 2, 2, 2, 2, 2, 2, 2, 2, 2, 1, 1],
      [1, 2, 1, 1, 1, 2, 3, 1, 1, 2, 1, 1, 1, 1, 1, 2, 2, 3, 1, 1, 1, 1],
      [1, 1, 1, 2, 2, 1, 1, 2, 2, 1, 3, 1, 1, 1, 1, 1, 1, 2, 1, 1, 3, 1],
      [1, 1, 1, 2, 1, 1, 2, 2, 2, 2, 1, 1, 1, 1, 1, 1, 1, 1, 1, 1, 3, 1],
      [2, 3, 2, 2, 2, 2, 2, 2, 2, 1, 2, 1, 1, 1, 3, 2, 3, 1, 3, 2, 2, 2],
      [1, 2, 2, 2, 2, 2, 3, 3, 3, 1, 3, 1, 1, 2, 2, 2, 2, 2, 2, 2, 2, 2],
      [3, 2, 2, 2, 2, 2, 2, 2, 3, 3, 3, 2, 2, 3, 3, 2, 2, 2, 2, 2, 2, 2],
      [2, 2, 1, 1, 2, 2, 2, 2, 2, 2, 2, 2, 3, 3, 2, 2, 3, 2, 2, 1, 2, 2],
      [2, 1, 2, 2, 2, 2, 1, 1, 2, 2, 2, 1, 1, 1, 1, 1, 3, 2, 2, 1, 2, 2],
      [2, 2, 2, 2, 2, 2, 3, 1, 1, 2, 2, 1, 1, 1, 1, 1, 1, 2, 1, 1, 1, 2],
      [2, 2, 1, 2, 2, 2, 1, 1, 1, 3, 2, 2, 2, 1, 2, 2, 2, 1, 1, 1, 1, 2]
    ],
    "buildings": [
      [0, 0, 0, 0, 0, 0, 0, 0, 0, 0, 0, 0, 0, 16, 0, 0, 0, 0, 0, 0, 16, 0],
      [0, 16, 10, 16, 16, 0, 0, 0, 0, 0, 0, 0, 0, 0, 0, 0, 0, 0, 0, 16, 0, 0],
      [
        16, 20, 0, 0, 0, 16, 16, 0, 0, 0, 0, 10, 10, 0, 0, 0, 17, 16, 16, 0, 10,
        10
      ],
      [16, 0, 0, 0, 0, 0, 0, 10, 0, 0, 16, 10, 10, 16, 0, 0, 10, 0, 0, 0, 0, 0],
      [
        0, 10, 10, 0, 0, 0, 0, 0, 16, 16, 0, 0, 0, 10, 16, 0, 10, 0, 0, 10, 0, 0
      ],
      [
        0, 0, 16, 16, 0, 14, 0, 16, 16, 16, 0, 0, 20, 0, 10, 10, 10, 0, 0, 0, 0,
        0
      ],
      [0, 0, 0, 10, 10, 0, 16, 16, 0, 14, 0, 0, 0, 0, 0, 0, 0, 0, 0, 0, 0, 0],
      [
        0, 16, 0, 0, 10, 10, 0, 0, 0, 0, 0, 16, 0, 0, 16, 0, 16, 16, 16, 10, 10,
        0
      ],
      [
        0, 0, 0, 0, 13, 10, 0, 16, 10, 10, 0, 16, 0, 10, 0, 0, 11, 16, 0, 10, 0,
        11
      ],
      [0, 0, 0, 0, 0, 0, 0, 0, 0, 10, 10, 0, 0, 0, 0, 10, 0, 19, 0, 0, 0, 0],
      [10, 0, 0, 0, 0, 0, 0, 16, 16, 0, 0, 0, 0, 0, 0, 10, 10, 0, 0, 0, 0, 0],
      [0, 16, 16, 0, 0, 0, 0, 20, 10, 0, 0, 12, 0, 0, 0, 0, 10, 10, 0, 0, 0, 0],
      [0, 0, 0, 10, 10, 10, 0, 0, 0, 0, 16, 16, 0, 0, 0, 0, 0, 10, 10, 0, 18, 0]
    ],
    "power": [
      [0, 0, 0, 0, 0, 0, 0, 0, 0, 0, 0, 0, 0, 0, 0, 0, 0, 0, 0, 0, 0, 0],
      [0, 0, 0, 0, 0, 0, 0, 0, 0, 0, 0, 0, 0, 0, 0, 0, 0, 0, 0, 0, 0, 0],
      [0, 0, 0, 0, 0, 0, 0, 0, 0, 0, 0, 0, 0, 0, 0, 0, 0, 0, 0, 0, 0, 0],
      [0, 0, 0, 0, 0, 0, 0, 0, 0, 0, 0, 0, 0, 0, 0, 0, 0, 0, 0, 0, 0, 0],
      [0, 0, 0, 0, 0, 0, 0, 0, 0, 0, 0, 0, 0, 0, 0, 0, 0, 0, 0, 0, 0, 0],
      [0, 0, 0, 0, 0, 0, 0, 0, 0, 0, 0, 0, 0, 0, 0, 0, 0, 0, 0, 0, 0, 0],
      [0, 0, 0, 0, 0, 0, 0, 0, 0, 0, 0, 0, 0, 0, 0, 0, 0, 0, 0, 0, 0, 0],
      [0, 0, 0, 0, 0, 0, 0, 0, 0, 0, 0, 0, 0, 0, 0, 0, 0, 0, 0, 0, 0, 0],
      [0, 0, 0, 0, 0, 0, 0, 0, 0, 0, 0, 0, 0, 0, 0, 0, 0, 0, 0, 0, 0, 0],
      [0, 0, 0, 0, 0, 0, 0, 0, 0, 0, 0, 0, 0, 0, 0, 0, 0, 0, 0, 0, 0, 0],
      [0, 0, 0, 0, 0, 0, 0, 0, 0, 0, 0, 0, 0, 0, 0, 0, 0, 0, 0, 0, 0, 0],
      [0, 0, 0, 0, 0, 0, 0, 0, 0, 0, 0, 0, 0, 0, 0, 0, 0, 0, 0, 0, 0, 0],
      [0, 0, 0, 0, 0, 0, 0, 0, 0, 0, 0, 0, 0, 0, 0, 0, 0, 0, 0, 0, 0, 0]
    ],
    "water": [
      [0, 0, 0, 0, 0, 0, 0, 0, 0, 0, 0, 0, 0, 0, 0, 0, 0, 0, 0, 0, 0, 0],
      [0, 0, 0, 0, 0, 0, 0, 0, 0, 0, 0, 0, 0, 0, 0, 0, 0, 0, 0, 0, 0, 0],
      [0, 0, 0, 0, 0, 0, 0, 0, 0, 0, 0, 0, 0, 0, 0, 0, 0, 0, 0, 0, 0, 0],
      [0, 0, 0, 0, 0, 0, 0, 0, 0, 0, 0, 0, 0, 0, 0, 0, 0, 0, 0, 0, 0, 0],
      [0, 0, 0, 0, 0, 0, 0, 0, 0, 0, 0, 0, 0, 0, 0, 0, 0, 0, 0, 0, 0, 0],
      [0, 0, 0, 0, 0, 0, 0, 0, 0, 0, 0, 0, 0, 0, 0, 0, 0, 0, 0, 0, 0, 0],
      [0, 0, 0, 0, 0, 0, 0, 0, 0, 0, 0, 0, 0, 0, 0, 0, 0, 0, 0, 0, 0, 0],
      [0, 0, 0, 0, 0, 0, 0, 0, 0, 0, 0, 0, 0, 0, 0, 0, 0, 0, 0, 0, 0, 0],
      [0, 0, 0, 0, 0, 0, 0, 0, 0, 0, 0, 0, 0, 0, 0, 0, 0, 0, 0, 0, 0, 0],
      [0, 0, 0, 0, 0, 0, 0, 0, 0, 0, 0, 0, 0, 0, 0, 0, 0, 0, 0, 0, 0, 0],
      [0, 0, 0, 0, 0, 0, 0, 0, 0, 0, 0, 0, 0, 0, 0, 0, 0, 0, 0, 0, 0, 0],
      [0, 0, 0, 0, 0, 0, 0, 0, 0, 0, 0, 0, 0, 0, 0, 0, 0, 0, 0, 0, 0, 0],
      [0, 0, 0, 0, 0, 0, 0, 0, 0, 0, 0, 0, 0, 0, 0, 0, 0, 0, 0, 0, 0, 0]
    ]
  }
}
